#a
3 0 0 3 0
1 0 0 0 3
0 0 0 0 0
0 0 0 0 0
0 0 0 0 0
0 0 0 0 0
0 0 0 0 0
0 0 0 2 0
0 0 0 0 0

#b
0 0 0 3 0
3 0 0 0 0
0 0 0 0 0
0 0 0 0 0
0 0 0 0 2
0 3 0 0 0
0 0 0 4 3
3 1 0 0 0
0 0 0 0 0

#c
0 3 0 3 0
0 1 0 0 3
0 0 0 0 3
0 4 0 2 0
0 0 0 0 0
0 0 0 0 0
0 0 0 4 0
3 0 0 2 0
0 0 0 0 0

#d
0 3 0 3 0
0 1 0 0 3
0 0 2 0 3
0 0 0 0 3
0 0 0 0 0
0 6 0 0 8
0 0 0 0 0
0 0 2 0 0
0 0 0 0 3

#e
0 0 0 3 0
3 0 0 0 0
3 6 0 0 8
1 0 0 0 0
0 2 4 0 2
0 3 0 7 0
0 0 0 3 0
2 0 7 0 3
0 0 0 0 0


